#####################################
#&           #                      #
#  #  ######   #  ####  ####  #######
#  #     #  #           #           #
#  #  ####  #  #  #  ####  ## #  ####
#  #     #  #  #  #     #  #  #     #
#  ####  #  ##    ####  #  #  #  ####
#              #                    #
#######  ####  #######  ####  #  #  #
#        #                 #  #     #
####  ##  ###  ##    ##########  ####
#     #        #  #           #     #
####  #  #  ####  ##########  ##  # #
#     #  #  #                 #  #  #
####  #  #  #  #  #######  #  #  #  #
#        #  #  #  #  #  #  #  #     #
####  ####  ####  #  #        #  #  #
#  #  #  #  #  #  #     #  #        #
#  #  #  #  #  #  #  #  #  ##    #  #
#        #           #  #     #  # .#
#####################################
