#####################################
#& #      #               # # # #   #
# ### # # # ###### ######## # # # # #
#     # #     # #               # # #
# ###   # ##### ##### ##### ### # ###
#     #           #   # #   #     # #
### ######### ####### # ### ### # # #
#                     # # # #   # # #
# ####### ##### ### ### # # ### # # #
#   # #     #           #   # # # # #
# ### # # ### ##### ####### # # ### #
#   #   #     #     #     # #   # # #
# # ### # ##### # ##### ### ### # # #
# #   # #       #           #       #
# # # # # ### ####### ### # # ### # #
#   #   #   # #     #     #   #   # #
# ### ### ### ### ### ### ### ### ###
# #   #   #             #       #   #
# # ##### # # ##### ### ### ### ### #
#   #       #     #           #    .#
#####################################