#####################################
#&  #   #                     #     #
# # ### ### ### # ##### # ### # # ###
#               #       # # #   # # #
# ### ### ### ##### ### # # ### # # #
# #   # #   # #   # #   # # #   # # #
# ### # ### ### ### ### # # ### # # #
#         #             # #     #   #
# ### ### # ##### ##### # # ####### #
#       #             # #   # #     #
# # ### # # ####### # #   ###     # #
# # # # # #         # # #     #   # #
# ### ### # ### # ########### # # # #
#   #   #   # #     #       #   #   #
# ##### # # # # # ### # # ##### ### #
#   #   # # # # #     # # #   # #   #
# ##### ### # # ##### # # ### # ### #
#   #       #     #         #     # #
### ### ######### # ### # # #####   #
#           #       #   #         #.#
#####################################
