#####################################
#&    # #     #               #     #
# ##### ### ### ### ### # # # ### # #
#               #   # # # # #     # #
# # ##### ## ## ### # # # # ##### ###
# #   #   #   # #     # # #   #     #
# # ##### ### # ##### # # ####### # #
#       #   #   # #             # # #
# # # # # ### ### # ####### # ### # #
#   # # #       # # #       #       #
# # ##### ##### # # ### ### ### # ###
###       # #     # #         # #   #
# #### #### ### # # # ##### ####### #
# #       #     #   #   #   #       #
# ### # ######### ### ### # ##### ###
#     # #   #                     # #
# ####### ### # ### ####### ### # # #
#             # #   #         # # # #
########### # ##### # ### ### # ### #
#             #     #   #   # #    .#
#####################################
