#####################################
#&             #                    #
# ### # ### # ## ## # # ### ##### ###
# #   #   # #       #   #     #     #
### # # ### # ##### # # # ### ##### #
#   # #           # # #   # #       #
# ### ### ###### ## ### ### # ### ###
# #     # # #           #     #     #
# ##### # # # ##### # #### ## # # ###
# #               # # # #   # # # # #
# ##### ##### ### # ### ### # # # # #
# #   # # # #   # #   #         #   #
# # ##### # ### ### # # ### ##### # #
#   #   #     #   # #     #   # # # #
# # # ### # ### ### ##### # ### ### #
# #       #             # #       # #
# # ### ################### # ### # #
# #   #   # # #     # #   # # #     #
# ### ### # # # ### # ### # # ## ## #
#               #           #     #.#
#####################################