#####################################################
#&#           #         #                       #   #
# # ######### # ##### # ##### ################# # # #
# #   # #     # #     #       #   #         # # # # #
# ### # # ####### ############# ### ##### # # # # # #
#     # #       # #     #   #       #     #   # # # #
####### ####### # # ### # # ### ##### ####### # ### #
#       #       #     #   #   #   #   #   #   #   # #
# ####### ################### ##### ### ### ##### # #
#         #   #       #       #     #   #   #     # #
# ######### # # # ### # ####### ##### ### ### ##### #
#       #   # # # #   # #   #   #     #     # #   # #
####### ### # # # # ### # ### # ##### # ##### # # # #
# #   #     # # # #     # #   # #   #   # #   # #   #
# # # ####### ### ####### # ### # # # ### # ### ### #
#   #       #   # #         # #   # #     # #   # # #
# ####### ##### # # ######### ##### ##### # # ### # #
# #     # #   # # #         #   #   #   # # #   # # #
# # ### # # # # # ######### ### # ### # ### ### # # #
#   #   #   #     #             #     #         #  .#
#####################################################