####################
#&                 #
# #########    #  ##
# #     #     #  # #
# #    #     #  #  #
# #   #     #  #   #
# #  ##    #  #  # #
# # #  #  #  #  #  #
# ##    ##  #  #  ##
# #     #  #  #  # #
# #    #  #  #  #  #
#     #  #  #  #   #
#    #  #  #  #  # #
#   #  #  #  #  #  #
#  #  #  #  #  #  ##
# #  #  #  #  #  # #
##  #  #  #  #  #  #
#  #  #  #  #  #   #
#    #     #     #.#
####################