###########
#        &#
#     ####
#    #   #
#   #    #
#  #     #
#  #     ##
#        .#
###########