###############################
#&  #     # #     #         # #
### # ### # ### ##### # ##### #
#     #       # #     # #     #
### ### ##### # # ##### ##### #
#   # #   # #       #     #   #
# ### # ### ### # # # ### ### #
# #         #   # # #   # # # #
##### ### ####### ##### # # # #
# #   #         # #   # # # # #
# # # # ##### # # # ### ### # #
#   # #   # # # #     # #     #
# ### # ### ####### ##### # ###
#   # # #         # #   # #   #
# ##### # # # ### # ### ##### #
# #   # # # #   #       #     #
### ##### ##### ### # # ##### #
#       #     #   # # #       #
##### # # ### ### ##### ### # #
# # # #     # #     # #   # # #
# # ##### ##### # ### # ### # #
#   # #       # # #       # # #
### # ##### # ### # # # #######
#           # #   # # #   #   #
# # ####### # # ####### # # ###
# #   # #   # #   #   # # #   #
### # # # # # ##### ### ### ###
# # # #   # #         #       #
# ### ### ####### ####### ### #
#     #     #         #   #  .#
###############################
