###############################
#&  #       #           #     #
# ### ### ### # ######### ### #
#   # #     # #   #   #     # #
# # ### ####### # # # ##### # #
# # # #       # #   # #   # # #
### # # ### # ####### # ### ###
#       #   # #     #   #   # #
# ####### ##### # ### ### ### #
#     #   #     #             #
####### ##### ### ####### ### #
# #   # #     #       # #   # #
# # # # # ####### # ### # #####
#   # # #   #   # # #         #
### # # # ### ### ### ### # ###
#   # #   #         #   # #   #
##### ########### ####### #####
# # #   # #       # #   #   # #
# # # # # ### ##### ### ### # #
#   # #     #     #       # # #
# # ##### ############### # # #
# #     #   #   #   #         #
### # # ### ### # ##### ### # #
# # # # #   #     #   #   # # #
# # ### ### # ### ### ##### ###
#     #       #   #   #       #
# ### ############# ######### #
# # #   #       #   # #   # # #
# # # # # # # ### ### # # # # #
#   # #   # #           #    .#
###############################