###############################
#&    #   #   # #   #         #
### # ### # ### ### ### # # ###
#   # # #   #     #   # # #   #
# ### # # ### # # # ### ### ###
#   #   # # # # #   # #   #   #
####### # # ####### # # ##### #
#             #     #     # # #
### # # ####### ##### ### # # #
#   # #   #   #   # # # #   # #
# # ##### # ##### # # # ### # #
# #   # #     #       #     # #
# ### # ####### # # ### #######
# # # #     #   # #   #       #
# # # # ##### ########### # ###
# #             #       # # # #
# ####### ########### ####### #
#       # #   #   # #   #     #
####### ### ### ### ### # #####
# #   # #       #   #   #     #
# # # # # ### # # # ### ### ###
#   #   # #   # # #   # #     #
# ##### # ### ### ##### # #####
#   # #     #                 #
### # ####### # ########### # #
#   # # #     #   #     #   # #
# ### # # ##### ####### ### # #
#       # #       #         # #
# ######### ### # ### ### ### #
# #         #   # #     #   #.#
###############################