###############################
#&      # # #   #       # #   #
### ##### # # # ### # # # # # #
# #   #     # #   # # #     # #
# ### # ##### ##### ###########
#   # # # #       #       #   #
# # # # # # ##### ### # ##### #
# #   #   # #         # #     #
# ### # ### ####### ### ### # #
#   #     # #       # # # # # #
# # ### # ##### ### # ### # ###
# # #   #     #   # #     # # #
### # ##### ### ### # ### # # #
#   #   # #     # #   # #     #
# # ##### # # ### # # # ### ###
# #     #   # #     #     #   #
# ### ### ### # ##### ### ### #
# # #   # #   #     #   # #   #
# # ##### ############# ##### #
# #   # # #         #       # #
# ### # # # ### ####### ### # #
#       #   # # # #     # # # #
### # ##### # ### ####### # ###
# # #     #               # # #
# # # # # # # ############# # #
# # # # # # #   #       # # # #
# ####### ######### ### # # # #
# # #   #         #   #   #   #
# # ### # # # ### # # ### ### #
#         # #   # # # #      .#
###############################