###############################
#&  #         #   #     #     #
# ####### # # # ### # ### #####
#   #   # # #   #   #   # #   #
# # # # # # ######### # # # # #
# #   # # #         # #     # #
##### ####### ### ######### # #
#             #     #       # #
# ### ##### ### ### ### ### # #
# #   #     # # # # #   #   # #
########### # ### ### # # # ###
#     #               # # #   #
# ############# ### # # #######
#   # #   #       # # #     # #
### # # # ######### # # ##### #
#   #   #     #     # # #     #
### # # # ##### ####### # ### #
#   # # # # #     # #     #   #
# # # ### # ####### # ####### #
# # # #   # #       # #   # # #
# ### # ### ### ### # # # # # #
# #   # # #       #   # #     #
# # ##### # # ### ######### ###
#           #   #   # #   # # #
### # ##### ####### # ### # # #
#   #     # #   #       # #   #
# # ##### ### ### ### # # ### #
# # # # #     #   #   #   #   #
# # # # ### ######### ### # # #
# #     #       #     #   # #.#
###############################