###############################
#&#   #       #               #
# # # ####### # ########### ###
# # # # # #   # #     #   #   #
# ### # # ### # # ### # ### ###
#     #             # #   #   #
##### # ##### ########### ### #
#   #   #   # # #   # #   #   #
# # # ##### ### # ### ### #####
# # #     #     #   #   #     #
# # # # # ### # # ### ### ### #
# #   # #   # # # # #       # #
# ##### ### ### # # ### # #####
#   # # #       #       #     #
##### # ### ########### # ### #
#       #           #   # #   #
# ### ####### # # ##### ### ###
# #         # # #         #   #
### ### # ####### # ### ##### #
#     # # #   # # #   # # # # #
# ####### # # # ####### # # ###
#   #       # #       #   #   #
# ########### ### # ### ### # #
#     # # #       #         # #
##### # # # ### # ### ### ### #
# # #     #   # # #   #   #   #
# # # # ### ####### # ### #####
#   # #   # # #     # # #   # #
# # ### ### # # ### # # # # # #
# #       # #     # #   # #  .#
###############################